Symbol	Description
A	Armor Minerals Inc
AA.H	Alba Minerals Ltd
AAC	Arak Resources Corp
AAD	Added Capital Inc
AAN	Alexander Nubia Internat
AAO	Augusta Industries Inc
AAP	Alpha Peak Leisure Inc
AAT	Ati Airtest Technologies
AAX	Advance Gold Corp
AAZ	Azincourt Uranium Inc
AB.H	Asbestos Corporation Lim
ABE	Abe Resources Inc
ABI	Abcourt Mines Inc.
ABM	Athabasca Minerals Inc.
ABN	Aben Resources Ltd.
ABR	Ashburton Ventures Inc.
ABU	Abenteuer Resources Corp
ABZ	Asiabasemetals Inc.
ACE.H	Ace Aviation Holdings In
ACH	Arch Biopartners Inc
ACK	Active Growth Capital In
ACL	Acl International Ltd
ACN	Asher Resources Corporat
ACS	Archon Minerals Limited
ACU	Aurora Solar Technologie
ACY.H	Acme Resources Corp
ADD	Arctic Star Exploration
ADE	Adex Mining Inc.
ADG	Arcus Development Group
ADI	Adriana Resources Inc.
ADK	Diagnos Inc.
ADZ	Adamera Minerals Corp
AE.A	Anterra Energy Inc. Cl
AEC	Artisan Energy Corporati
AEN	Antrim Energy Inc
AER	Alternative Earth Resour
AFE	Africa Energy Corp
AFM	Alphamin Resources Corp.
AFR	African Metals Corporati
AFS.H	Afrasia Mineral Fields Inc.
AFY	Anthem United Inc
AGB	Atlantic Gold Corporatio
AGC	Amarillo Gold Corp.
AGD	Antioquia Gold Inc.
AGE	Adventure Gold Inc.
AGG	African Gold Group Inc.
AGH	Canadian Silver Hunter I
AGL	Aguila American Gold Ltd
AGM	Aldridge Minerals Inc.
AGO	Aurcrest Gold Inc
AGQ	Arian Silver Corp.
AGV	Agave Silver Corp
AGX	Amador Gold Corp
AGY	Atom Energy Inc
AHI	Agility Health Inc
AHR	Amarc Resources Ltd.
AHS	Alta Natural Herbs and S
AHU	Arctic Hunter Energy Inc
AII	Almonty Industries Inc
AIN.H	Aintree Resources Inc
AIS.H	Ais Resources Limited
AIX	Alix Resources Corp.
AKH	Alaska Hydro Corporation
AKM	Act360 Solutions Ltd.
AKR	Ackroo Inc
AL	Alx Uranium Corp
ALD	Aldever Resources Inc
ALG	Algold Resources Ltd
ALI	Altitude Resources Inc
ALL.H	Allante Resources Ltd
ALM	Alliance Mining Corp
ALN	Aldrin Resource Corp.
ALP	Alabama Graphite Corp
ALQ	Alq Gold Corp
ALV	Alvopetro Energy Ltd
ALW	All In West!  Capital Co
ALY	Analytixinsight Inc
ALZ	Aldershot Resources Ltd.
AM.H	Automodular Corporation
AME	Abacus Mining & Explorat
AMG	Am Gold Inc.
AMK	American Creek Resources
AML	Argus Metals Corp.
AMO	Altan Rio Minerals Limit
AMT	Amato Exploration Ltd.
AMU	Ami Resources Inc
AMX	AMEX Exploration Inc
AMY	American Manganese Inc.
AMZ	Almadex Minerals Limited
AN	Arena Minerals Inc
ANB	Anglo-Bomarc Mines Ltd
ANE	Altan Nevada Minerals Li
ANF	Anfield Nickel Corp.
ANG	Angel Gold Corp
ANK	Angkor Gold Corp
ANZ	Alianza Minerals Ltd
AOS	Alberta Oilsands Inc.
AOT	Ascot Resources Ltd.
AOZ	Aurania Resources Ltd
APA	Alliancepharma Inc
APC	Advanced Proteome Therap
APE	Apogee Silver Ltd
APH	Aphria Inc
APL	Appulse Corp.
APN	Altiplano Minerals Ltd
APO	Acasti Pharma Inc
APV	Apivio Systems Inc
AQ	African Queen Mines Ltd.
AQM	Aqm Copper Inc.
AQS	Aequus Pharmaceuticals I
ARA	Anconia Resources Corp
ARB.H	Ardonblue Ventures Inc
ARC	Arian Resources Corp
ARD	Armada Data Corp.
ARH	Altima Resources Ltd.
ARI	Acme Resources Inc.
ARK	Archer Petroleum Corp
ARR	Arco Resources Corp
ARS	Asiamet Resources Limited
ART	Arht Media Inc
ARW	Aroway Energy Inc
ARY	Anfield Resources Inc
ASC	Athabasca Nuclear Corp
ASG	Aurora Spine Corporation
ASL	Argentum Silver Corp.
ASM	Avino Silver and Gold Mi
ASN	Asian Mineral Res Ltd.
AST	Astur Gold Corp
AT	Acuityads Holdings Inc
ATC	Atac Resources Ltd.
ATE	Antibe Therapeutics Inc
ATG	Atlanta Gold Inc.
ATI	Altai Resources Inc
ATM	Atacama Pacific Gold Cor
ATU	Altura Energy Inc
ATV	Alto Ventures Ltd
ATW	Atmanco Inc
ATX	Argentex Mining Corporat
ATY	Atico Mining Corporation
AU	Aurion Resources Ltd.
AUA	Adanac Molybdenum Corpor
AUG	Auryn Resources Inc
AUN	Aurcana Corporation
AUR	Aurgent Resource Corp
AUT	Austin Resources Ltd
AUU	Aura Silver Resources In
AUV	Augyva Mining Resources
AUX	Auramex Resource Corp
AVA	Aurvista Gold Corporatio
AVC	American Vanadium Corp.
AVD	Avidus Management Group
AVE	Aveda Transport and Ener
AVM	Avarone Metals Inc
AVN	Avanti Energy Inc
AVT	Alloycorp Mining Inc
AVU	Avrupa Minerals Ltd.
AVX	Altair Gold Inc
AVZ	Avala Resources Ltd
AWE	Thunderstruck Resources
AWI	Advent Wireless Inc
AWS	Arrowstar Resources Ltd
AXC	Alexandra Capital Corp
AXE	Acceleware Ltd
AXG	Antipodes Gold Limited
AXM	Axmin Inc
AXQ	Axe Exploration Inc
AYQ.A	Test Symbol
AYQ.H	Test Symbol
AZM	Azimut Exploration Inc.
AZN	Arcturus Ventures Inc
AZX	Alexandria Minerals Corp
B	Bcm Resources Corporatio
BAJ	Baja Mining Corp
BAL.H	Balto Resources Ltd.
BAT	Batero Gold Corp.
BAV.H	Bravern Ventures Ltd
BAY	Aston Bay Holdings Ltd
BBB	Brixton Metals Corporati
BBI	Blackbird Energy Inc
BCC	The Canadian Bioceutical
BCF	Builders Capital Mortgag
BCG	Bcgold Corp.
BCK	Blind Creek Resources Lt
BCM	Bear Creek Mining Corp.
BCN	Bacanora Minerals Ltd
BCR.H	Bluerock Ventures Corp
BCT	Briacell Therapeutics Co
BCU	Bell Copper Corp
BCU.H	Bell Copper Corporation
BEA	Belmont Resources Inc
BEE	Bee Vectoring Technologi
BEL	Belvedere Resources Ltd.
BEN	Butte Energy Inc
BET	Bethpage Capital Corp
BEX	Benton Resources Inc
BFD	Beaufield Resources Inc.
BFK.P	0Nebfk Capital Corp
BFM	Bluefire Mining Corp
BFT	Bioflex Technologies Inc
BG	Barisan Gold Corporation
BGD	Bullion Gold Resources C
BGE	Bison Gold Resources Inc
BGL	Bandera Gold Ltd.
BGM	Barkerville Gold Mines L
BHK	Bhk Mining Corp.
BHR	Blackheath Resources Inc
BHS	Bayhorse Silver Inc
BHT	Braveheart Resources Inc
BHV	Bellhaven Copper and Gol
BIO	Biosign Technologies Inc
BIT	Black Isle Resources Cor
BKD	Breaking Data Corp
BKM	Pacific Booker Minerals
BKR	Berkwood Resources Ltd
BLM	Blumetric Environmental
BLN	Blackline Gps Corp
BLR	Blackhawk Resource Corp
BM	Bc Moly Ltd
BME	Barsele Minerals Corp
BMG	Battle Mountain Gold Inc
BMK	Macdonald Mines Expl Ltd
BML	Barker Minerals Ltd
BMR.H	Bradmer Pharmaceuticals
BMW	Brand Marvel Worldwide C
BNR	Brionor Resources Inc.
BOB	Global Hunter Corp.
BOC	Blueocean Nutrasciences
BOE	Americas Petrogas Inc.
BOL	Bold Ventures Inc.
BOR	Border Petroleum Limited
BOW	Bowmore Exploration Ltd.
BOZ	Banks Island Gold Ltd
BPE	Brightpath Early Learnin
BPL	Bluedrop Performance Lea
BQE	Bioteq Environmental Technologies Inc.
BRI	Brazil Resources Inc
BRI.WT	Brazil Resources Inc Wts
BRL	Bearclaw Capital Corp
BRM	Biorem Inc.
BRN.PR.A	Brookfield Investments C
BRO.H	Barksdale Capital Corp
BRS	Brs Resources Ltd
BRU	Brunswick Resources Inc
BRV.H	Brs Ventures Ltd
BSH	Bayshore Petroleum Corp.
BSK	Blue Sky Uranium Corp
BSP	Big Sky Petroleum Corp
BSR	Bluestone Resources Inc
BSV.H	Bold Stroke Ventures Inc
BTC	Benton Capital Corp
BTI	Bioasis Technologies Inc
BTL	Btl Group Ltd
BTR	Bonterra Resources Inc.
BTT	Bitterroot Resources Ltd
BTV	Bluerush Media Group Cor
BUD	Satori Resources Inc
BUS	Grande West Transportati
BVA	Bravada Gold Corporation
BVE	Burnstone Ventures Inc
BVO	Bevo Agro Inc.
BW	Brookwater Ventures Inc
BWR	Black Widow Resources In
BXR	Blue River Resources Ltd
BYM.H	Baymount Incorporated
BYN	Banyan Gold Corp
BYU	Bayswater Uranium Corpor
BZ	Benz Mining Corp.
CA	Codrington Resource Corp
CAC	Canamax Energy Ltd
CAC.WT	Canamax Energy Ltd Wts
CAD	Colonial Coal Internatio
CAF	Canaf Group Inc.
CAP	Castle Peak Mining Ltd
CAT	Chimata Gold Corp
CAY	Cache Exploration Inc.
CBA	Champion Bear Res Ltd
CBE	Cabo Drilling Corp.
CBG	Chibougamau Independent
CBI	Colibri Resource Corp.
CBJ	Cb Gold Inc
CBS	Bard Ventures Ltd
CBV	Cobra Venture Corporatio
CBX	Cortex Business Solution
CC.H	Cascade Resources Ltd
CCB	Canada Carbon Inc
CCC	Cornerstone Metals Inc
CCE	Commerce Resources Corp.
CCK	Canada Coal Inc
CCY	Catalyst Copper Corp
CD	Cantex Mine Development
CDA	Canuc Resources Corporat
CDB	Cordoba Minerals Corp
CDC	Cadillac Ventures Inc.
CDG	Candente Gold Corp
CDN	Canadream Corporation
CDX	Cassidy Gold Corp.
CE	Canada Energy Partners I
CEA	Cerus Energy Group Ltd
CEB	Ceiba Energy Services In
CEC	Compliance Energy Corp
CEI	Crystal Exploration Inc
CEL.H	Columbus Energy Limited
CEM	Constantine Metal Resour
CEP.P	Cliffside Capital Ltd
CEV	Cap Ex Iron Ore Ltd
CEY.H	Century Energy Ltd
CFB	Chieftain Metals Corp
CFL	Cerf Incorporated
CFM	Confederation Minerals L
CFO	Clifton Star Resources I
CFY	Changfeng Energy Inc.
CGC	Canopy Growth Corporation
CGD	Carlin Gold Corp.
CGE	Corex Gold Corp
CGM	California Gold Mining I
CGP	Cornerstone Capital Reso
CGT	Columbus Gold Corporatio
CGW	Corazon Gold Corp
CH	Urban Select Captial Cor
CHC	Chc Student Housing Corp
CHK.P	Campar Capital Corporati
CHN	China Education Resource
CHQ	Carrus Capital Corporati
CHY.H	Cypress Hills Resource C
CID	Cicada Ventures Ltd.
CIN	Canadian Intl Minerals I
CIO	Central Iron Ore Limited
CIP.H	Canadian International P
CIT.H	Cr Capital Corp
CJC	Canada Strategic Metals
CKB	Calico Resources Corp
CKC.H	Cricket Resources Inc
CKG	Chesapeake Gold Corp.
CKK	Cordy Oilfield Services
CKR	Caribou King Resources L
CKT	Cricket Media Group Ltd
CKZ.H	Caspian Energy Inc
CL	Crailar Technologies Inc
CL.H	Crailar Technologies Inc
CLB	Colombia Crest Gold Corp
CLH	Coral Gold Resources Ltd
CLI	Clearford Water Systems
CLV	Canoe Mining Ventures Co
CLZ	Canasil Resources Inc.
CMB	Cmc Metals Ltd.
CMD	Commander Resources Ltd
CMI	C-Com Satellite Systems
CMJ	Colombian Mines Corporat
CMU	Comet Industries Ltd.
CMV	China Minerals Mining Co
CMX	Chilean Metals Inc
CN	Condor Resources Inc.
CNC	Canyon Copper Corp
CNG	Canadian Mining Company
CNH	Crownia Holdings Ltd
CNO	California Nanotechnolog
CNS	Contagious Gaming Inc
CNX	Callinex Mines Inc
CNY	Cancana Resources Corp
CO	Canadian Orebodies Inc.
COB.U	Cohbar Inc
COL	Copper North Mining Corp
COO	Offsetters Climate Solut
COQ	Rooster Energy Ltd
COR	Camino Minerals Corporat
COT	Critical Outcome Technol
COV	Covalon Technologies Ltd
CPA	Chinapintza Mining Corp
CPC	Canadian Platinum Corp
CPE.H	Capital Pro Egaux Inc
CPL	Copper Lake Resources Lt
CPM	Crystal Peak Minerals In
CPS	Claim Post Resources Inc
CPV	Copper Creek Gold Corp.
CQR	Conquest Resources Ltd.
CRB	Cariboo Rose Resources L
CRD	Coronado Resources Ltd
CRE	Critical Elements Corpor
CRF	Coronet Metals Inc
CRO	Canadian Arrow Mines Ltd
CRS	Cardiff Energy Corp
CRU	Cameo Resources Corp
CRV	Cresval Capital Corp.
CRX	Cerro Mining Corp
CSC	Canex Energy Corp
CSL	Comstock Metals Ltd
CSO	Corsa Coal Corp
CSQ	Canamex Resources Corp
CST	Co2 Solutions Inc.
CSV	Caracara Silver Inc
CSX	Clean Seed Capital Group
CT	Centenara Mining Corpora
CTG.H	Global Minerals Ltd
CTM	Canterra Minerals Corpor
CTN	Centurion Minerals Ltd.
CTO	Circa Enterprises Inc.
CTZ	Cencotech Inc.
CUC	Carube Copper Corp
CUG	Cyprium Mining Corp
CUI	Currie Rose Resources In
CUO	Copper One Inc.
CUU	Copper Fox Minerals Inc.
CV.H	Chantrell Ventures Corp.
CVA	Cava Resources Inc
CVB.H	Compass Gold Corporation
CVR	CDN Oil Recovery & Remed
CVV	Canalaska Uranium Ltd
CVX	Cematrix Corporation
CWC	Cwc Energy Services Corp
CWM	Crown Mining Corp
CWN	Cwn Mining Acquisition C
CWQ.H	Curlew Lake Resources Inc
CWS.H	Cons Westview Res Corp
CWV	Crown Point Energy Inc
CX	Carbonone Technologies I
CXB	Calibre Mining Corp.
CXD	Cadan Resources Corporat
CXG.A	Clemex Technologies Inc.
CXM	Carmax Mining Corp
CXO	Colorado Resources Ltd
CXV	Convalo Health Internati
CY	Clear Mountain Resources
CYF	Canyon Creek Food Co Ltd
CYM	Cymat Technologies Ltd
CYP	Cypress Development Corp
CYX	Calyx Bio-Venture Inc.
CZ	Cassius Ventures Ltd.
CZH	Crazy Horse Resources In
CZO	Ceapro Inc
CZX	Canada Zinc Metals Corp.
CZY	Caza Gold Corp.
DAI.H	Datinvest International
DAL	Dalmac Energy Inc.
DAN	Arianne Phosphate Inc
DAP.U	Xpel Technologies Corp
DAU	Desert Gold Ventures Inc
DBL	Darnley Bay Resources Li
DBV	Doubleview Capital Corp
DCY	Discovery-Corp. Enterpri
DDD.H	Angel Bioventures Inc
DE	Decisive Dividend Corpor
DEC	Decade Resources Ltd.
DEF	Defiance Silver Corp
DEQ	Deq Systems Corp
DEX	Detector Exploration Ltd
DFI	Diamond Field In J
DGO	Durango Resources Inc
DHR	Discovery Harbour Resour
DIA	Margaret Lake Diamonds I
DIG.H	Digger Resources Inc.
DJI	Dajin Resources Corp.
DLS	Dealnet Capital Corp
DLV	Dv Resources Ltd
DMA	Diamedica Inc.
DME.H	Dynamic Oil and Gas Expl
DMG.H	Dmd Digital Health Conne
DMI	Diamcor Mining Inc.
DMR	Damara Gold Corp
DNI	Dni Metals Inc
DNX	Dynex Power Inc.
DOS	Dios Exploration Inc
DOX	Dorex Minerals Inc.
DPH	Duncan Park Holdings Cor
DRN.H	Delrand Resources Limited
DRV	Duran Ventures Inc.
DSF	Dusolo Fertilizers Inc
DSR	Desert Star Resources Lt
DSY	Destiny Media Technologi
DUG	Distinct Infrastructure
DV	Dolly Varden Silver Corp
DVC.H	Devin Energy Corporation
DVG	Divergent Energy Service
DVI	Dunnedin Ventures Inc
DVN	Discovery Ventures Inc
DVO.U	Delavaco Residential Pro
DVR	Deveron Resources Ltd
DVT	Divestco Inc.
DWS	Diamond Estates Wines An
DXA	Doxa Energy Ltd.
DXE	Dualex Energy Internatio
DXX	Dxstorm.Com Inc.
DYA	Dynacert Inc
DYG	Dynasty Gold Corp.
DYU.H	Dawson Gold Corp
EAM	East Africa Metals Inc
EAS	East Asia Minerals Corp.
EBM	Eastwood Bio Medical Can
EBN	Epicore Bionetworks Inc.
EBY	Emerald Bay Energy Inc.
ECC	Ethos Gold Corp
ECR	Cartier Resources Inc.
ECT	Ellipsiz Communications Ltd
ED.UN	Edgefront Real Estate In
EDE	Edge Resources Inc.
EDW	Edgewater Exploration Lt
EEC	88 Capital Corp
EEL	Esrey Energy Ltd
EEN	Estrella Intl Energy Svc
EFT	Eft Canada Inc.
EGA	Eagle Graphite Incorpora
EGD	Energold Drilling Corp.
EGT	Eguana Technologies Inc
EGX	Ecuador Gold and Copper
EHT	Enerdynamic Hybrid Tech
EIL	Empire Industries Ltd.
EKG	Cardiocomm Solutions In
EL	Engagement Labs Inc
ELC	Elysee Development Corp
ELM	Element Lifestyle Retirement Inc
ELN	El Nino Ventures Inc
ELO	Eloro Resources Ltd.
ELS	El Tigre Silver Corp
ELT	Electra Stone Ltd.
ELY	Ely Gold & Minerals Inc.
EMH	Emerald Health Therapeut
EMO	Emerita Resources Corp
EMR	Emgold Mining Corporatio
EMT	Entourage Metals Ltd
EMX	Eurasian Minerals Inc
ENA	Enablence Technologies I
ENG	Energulf Resources Inc.
ENP	Enpar Tech Inc.
ENW	Enwave Corp
EOG	Eco Atlantic Oil and Gas
EOR	Enhanced Oil Resources I
EOX	Euromax Resources Ltd.
EPL	Eagle Plains Resources L
EPO	Encanto Potash Corp.
EPR	Empire Rock Minerals Inc
EPT	Empower Technologies Cor
EQ	Eq Inc
EQG	Eqube Gaming Limited
EQT	Equitas Resources Corp
ERA	Elcora Resources Corp
ERC	Eros Resources Corp
ERG	Ergoresearch Ltd
ERN	Earny Resources Ltd
ES	Eight Solutions Inc.
ESE	Estec Systems Corp.
ESK	Eskay Mining Corp.
ESU	Eestor Corporation
ESV	Esi Environmental Sensor
ETF	Eastfield Resources Ltd.
EU	Encore Energy Corp
EUK	Eureka Resources Inc.
EUO	Eurocontrol Technics Gro
EUU	European Uranium Resourc
EV	Erin Ventures Inc.
EVC.H	Everfront Ventures Corp
EVM	Evrim Resources Corp
EVR	Everton Resources Inc.
EW	East West Petroleum Corp
EWK	Earthworks Industries In
EWS	Environment Waste Intl
EXC	Essex Angel Capital Inc
EXG	Exgen Resources Inc
EXO	Exo U Inc
EXS	Explor Resources Inc.
EXX	Equitorial Exploration C
EY	Extenway Solutions Inc.
EYC	Eyecarrot Innovations Co
FA	Fountain Asset Corp
FAC	First Americas Gold Corp
FAM	Family Memorials Inc.
FAN	Gaming Nation Inc
FAS	Fantasy Aces Daily Fantasy Sports
FBF	Fab-Form Industries Ltd.
FBI	Franchise Bancorp Inc.
FBX	First Bauxite Corporatio
FCD.UN	Firm Capital Property TR
FCF	Fcf Capital Inc
FCV	Focus Ventures Ltd.
FDC	Forum Uranium Corp
FDR	Flinders Resources Limit
FEE	Free Energy Internationa
FEM	Ferrum Americas Mining I
FEN	Forent Energy Ltd.
FEO	Oceanic Iron Ore Corp
FEX	Fjordland Exploration In
FF	First Mining Finance Cor
FFC.H	Four River Ventures Ltd
FFF	Northern Frontier Corp
FFM	Formation Fluid Manageme
FG	Falcon Gold Corp
FGC	Frontline Gold Corporati
FGD	First Global Data Limite
FGH	First Growth Holdings Lt
FIX	Firebird Resources Inc
FLX	Fieldex Exploration Inc.
FLY	Flyht Aerospace Solution
FMG	First Mexican Gold Corp
FMK.P	Flying Monkey Capital Co
FMM	Full Metal Minerals Ltd
FMR	Fairmont Resources Inc
FMS	Focus Graphite Inc
FMX	First Mountain Explorati
FNC	Fancamp Exploration Ltd.
FNR	49 North Resources Inc.
FO	Falcon Oil & Gas Ltd
FOM	Foran Mining Corporation
FPC	Falco Resources Ltd
FRI	Freeport Resources Inc.
FRN	Feronia Inc
FSW	Fireswirl  Technologies
FTI	Fti Foodtech Internation
FTJ.H	Fort ST James Nickel Corp
FTR	Firesteel Resources Inc
FUR	Fura Emeralds Inc
FUU	Fission 3.0 Corp
FV	Firestone Ventures Inc
FVR	Finavera Wind Energy Inc
FYL	Finlay Minerals Ltd.
GAL	Galantas Gold Corp.
GAR	Green Arrow Resources In
GAZ.UN	Fronsac Capital REIT Uni
GB	Ginger Beef Corp.
GBB	Gold Bullion Development
GBE	Goldbelt Empires Limited
GBL	Gb Minerals Ltd
GBN	Golden Band Resources In
GBR	Great Bear Resources Ltd
GCC.H	Golden Cariboo Resources
GCN	Goldcliff Resources Corp
GCO	Global Cobalt Corporatio
GCR	Gespeg Copper Resources
GCU	Gold Canyon Resources In
GCX	Granite Creek Gold Ltd
GDM	Goldstar Minerals Inc
GDN	Gordon Creek Energy Inc
GDX	Goldex Resources Corp
GEM	Pele Mountain Resources
GER	Glen Eagle Resources Inc
GES	Gemoscan Canada Inc
GFK	Gfk Resources
GFN	Gold Finder Explorations
GG	Galane Gold Ltd
GGC	G4G Capital Corp
GGG	Graphene 3D Lab Inc
GGI	Garibaldi Resources Corp
GGL	Ggl Resources Corp.
GGY	Goldeye Explorations Ltd
GHR	Golden Harp Resources In
GI	Gem International Resour
GIT	Gitennes Exploration Inc
GJB	Gold Jubilee Capital Cor
GKX	Gemini Corporation
GLB	Goldbank Mining Corporat
GLD	Goldon Resources Ltd
GLK	Great Lakes Graphite Inc
GLW	Galway Gold Inc
GMA	Geomega Resources Inc
GMN	Gobimin Inc
GMV	Gmv Minerals Inc.
GN	Gonzaga Resources Ltd
GNC	Gainey Capital Corp
GNF	Greenfields Petroleum Co
GNF.DB	Greenfields Petroleum Co
GNG	Golden Goliath Resources
GNH	Golden Hope Mines Ltd
GNT	Gentor Resources Inc
GOD	Goldrush Resources Ltd.
GOE	Goldeneye Resources Corp
GOG	Golden Tag Resources Ltd
GOK	Ginsms Inc.
GOM	Golden Dawn Minerals Inc
GOP	Gourmet Ocean Products I
GP	Golden Peak Minerals Inc
GPE	Great Prairie Energy Ser
GPG	Grande Portage Resources
GPH	Graphite One Resources I
GPL	Galileo Petroleum Ltd
GPM	Gpm Metals Inc
GPV	Greenpower Motor Company
GPW	Grand Power Logistics Gr
GPY	Golden Predator Mining C
GQ	Great Quest Fertilizer L
GQC	Goldquest Mining Corp.
GR	Great Atlantic Resources
GRA.H	Graniz Mondal Inc
GRB	Greenbriar Capital Corp
GRC	Grenville Strategic Roya
GRC.DB	Grenville Strategic Roya
GRC.WT	Grenville Strategic Roya
GRG	Golden Arrow Res Corp.
GRI	Galore Resources Inc
GRM	Goldrock Mines Corp
GRR	Golden Reign Resources L
GRS.H	Griffin Skye Corporation
GRV	Gold Reach Resources Ltd
GRX.H	Greenshield Explorations
GRZ	Gold Reserve Inc
GSA	Groundstar Resources Ltd
GSH	Golden Share Mining Corp
GSI	Gatekeeper Systems Inc
GSP	Gensource Potash Corpora
GSR	Goldstrike Resources Ltd
GSS	Gossan Resources Limited
GSV	Gold Standard Ventures C
GSW	Green Swan Captial Corp
GTA	Gta Resources and Mining
GTB	Greatbanks Resources Ltd
GTC	Getty Copper Inc.
GTD.H	Gstaad Capital Corp
GTG	Great Thunder Gold Corp
GTO.H	Galena International Res
GTP	Colt Resources Inc
GUF	Gulf & Pacific Equities
GUG	Gungnir Resources Inc
GUL	Gulf Shores Resources Lt
GUM	Gold Mountain Mining Cor
GUN	Gunpoint Exploration Ltd
GV	Guerrero Ventures Inc
GVG	Grenville Gold Corp.
GWA	Gowest Gold Ltd
GWM	Galway Metals Inc
GWQ	Gwr Resources Inc
GXM	Geodex Minerals Ltd
GXR	Georox  Resources Inc.
GXS	Goldsource Mines Inc
GZD	Grizzly Discoveries Inc.
GZZ	Golden Valley Mines Ltd.
HA	Hodgins Auctioneers Inc
HBE	Hornby Bay Mineral Explo
HBK	Highbank Resources Ltd.
HEC	Handa Copper Corporation
HEG.H	Homeland Energy Group Ltd
HEI	Huntington Exploration I
HEM	Hemostemix Inc
HEO	H2O Innovation Inc.
HGO	Hawkeye Gold and Diamond
HI	Highland Copper Company
HIT	Hit Technologies Inc
HJI	Helijet International In
HLM	Houston Lake Mining Inc
HME	Hemisphere Energy Corpor
HMI	Hinterland Metals Inc.
HMT	Halmont Properties Corp
HMX	Hunt Mining Corp.
HN	High North Resources Ltd
HNC	Hard Creek Nickel Corpor
HOP	Telehop Communications I
HPI	Highbury Projects Inc.
HPL	Horizon Petroleum Plc
HPY	Happy Creek Minerals Ltd
HRC	Helio Res Corp.
HRE	Stans Energy Corp
HRH	Hillcrest Petroleum Ltd
HRL	Hansa Resources Limited
HSR	Homestake Resource Corp
HTC	Htc Purenergy Inc.
HTL	Hamilton Thorne Ltd
HTR	Heatherdale Resources Lt
HUD	Hudson Resources Inc.
HVG	Harvest Gold Corp
HWK.A	Hawk Exploration Ltd. Cl
HWY	Highway 50 Gold Corp
HXC	Hfx Holding Corp
IB	Ibc Advanced Alloys Corp
IBC	International Bethlehem
IBH	International Barrier Te
IBT	Ibex Technologies Inc.
ICG	Integra Gold Corp.
ICM	Iconic Minerals Ltd
ICO	Ico Therapeutics Inc.
ICU	Global Copper Group Inc
IDI	Indico Resources Ltd.
IDL	Imaging Dynamics Company
IDW	Id Watchdog Inc.
IEI	Imperial Equities Inc.
IES	Intercept Energy Service
IFD	Intrinsic4D Inc
IFM	Infrastructure Materials
IFR	International Frontier R
IFX	Imaflex Inc
IGC.H	Igc Resources Inc
IGD	Intigold Mines Ltd
IGO	Independence Gold Corp
IGP	Imperial Ginseng Product
IGX	Intelgenx Technologies C
IKM	Ikkuma Resources Corp
ILA	Ilookabout Corp.
ILC	International Lithium Co
IMA	I-Minerals Inc.
IML	Iberian Minerals Ltd
IMM	Immunotec Inc.
IMR	Imetal Resources Inc
IMT	International Montoro Re
IMU	Biommune Technologies In
INA	Iona Energy Inc
INM	Northair Silver Corp
INP	Input Capital Corp
INT	Intertainment Media Inc.
INX	In-Touch Survey Systems
IO	Inca One Gold Corp
IOG	Ironhorse Oil & Gas Inc.
IOT	Innovotech Inc.
IOU	Iou Financial Inc
IPC	Iplayco Corporation Ltd.
IPD	International Parkside P
IPT	Impact Silver Corp.
IQ	Airiq Inc.
IRC	Ironside Resources Inc
IRI	Iemr Resources Inc
ISD	Isign Media Solutions In
ISS	International Samuel Exp
ITM	Intema Solutions Inc
ITT	Internet of Things Inc
IVF.H	Invictus Financial Inc
IVI	Ivrnet Inc.
IVS	Inventus Mining Corp
IVX	Inventronics Limited
IWG	Iwg Technologies Inc
IXI	Indigo Exploration Inc.
IZN	Inzinc Mining Ltd
JAG	Jaguar Mining Inc
JAU	Jet Gold Corp
JAX	Jaxon Minerals Inc.
JCI.H	Jm Capital II Corp
JCO	Jericho Oil Corporation
JDL	Lowell Copper Ltd
JDN	Jayden Resources Inc
JEN.H	The Jenex Corporation
JET	Jet Metal Corp
JFC	Jaguar Financial Corp
JFI	Jemi Fibre Corp
JLR	Jiulian Resources Inc.
JML	Jag Ltee Les Mines
JNX	Junex Inc.
JP	Jackpot Digital Inc
JSP	Jasper Mining Corporatio
JTC	Jemtec Inc
JTR	Greenspace Brands Inc
JVL.H	Javelle Capital Corp
JX	S&P/TSX Venture Composit
JZR	Jazz Resources Inc.
KAM	Kaminak Gold Corporation
KAP	Kapuskasing Gold Corp
KAR	Karmin Exploration Inc
KAS	Khalkos Exploration Inc
KAY	Karsten Energy Corp
KBG	King S Bay Gold Corp.
KBT	Kombat Copper Inc
KCC	Kincora Copper Limited
KCK	Kicking Horse Energy Inc
KDI	Kennady Diamonds Inc
KE.H	Karoo Exploration Corp
KEK	Keek Inc
KES	Kesselrun Resources Ltd
KFG	Kfg Resources Ltd.
KG	Klondike Gold Corp
KGC	Kestrel Gold Inc
KGL	Kilo Goldmines Ltd.
KIT	Kitrinor Metals Inc
KIV	Kivalliq Energy Corporat
KLE	Kingsland Energy Corp
KLH	Stellar Biotechnologies
KLM	Kermode Resources Ltd.
KMC.H	Kmt Hansa Corp
KMI.H	Killdeer Minerals Inc
KMT	Komet Resources Inc
KNA	Kenna Resources Corp
KNE	Kane Biotech Inc
KNG	Kingsmen Resources Ltd
KNO.H	Cellstop Systems Inc
KNX	Knick Exploration Inc.
KR	Kr Investment Ltd
KRS	Kairos Capital Corporati
KS	Klondike Silver Corp
KSK	Kiska Metals Corporation
KTN	Kootenay Silver Inc
KUB	Cub Energy Inc
KUT	Redishred Capital Corp.
KWF	Knightswood Financial Corp.
KXM	Kobex Capital Corp
KYU	Kaiyue International Inc
KZD	Kaizen Discovery Inc
KZX	Kazax Minerals Inc
KZZ	Nunavik Nickel Mines Ltd
LA	Los Andes Copper Limited
LAB	Imperus Technologies Cor
LAD	New Carolin Gold Corp
LAK	Lakeside Minerals Inc
LAN	Declan Resources Inc
LAQ	La Quinta Resources Corp
LAT	Latin American Minerals
LBI.H	Lions Bay Capital Inc.
LDM	Lago Dourado Minerals Lt
LE	Lariat Energy Ltd.
LEN	Lund Enterprises Corp
LET	Letho Resources Corp
LGN	Legend Gold Corp
LGO	Largo Resources Ltd.
LHC	Long Harbour Exploration
LHR	Lakeview Hotel Invest Co
LHR.DB.C	Lakeview Hotel Invest Co
LHR.DB.D	Lakeview Hotel Invest Co
LIO	Lion One Metals Limited
LIR	Lamelee Iron Ore Ltd
LIX	0Nelithium X Energy Corp
LL	Canada Rare Earth Corp
LLC	Lorraine Copper Corp.
LLG	Mason Graphite Inc
LM	Lingo Media Corporation
LMD	Led Medical Diagnostics
LME	Laurion Mineral Explorat
LMG	Lincoln Mining Corporati
LMR	Lomiko Metals Inc.
LMS	Less Mess Storage Inc
LND	Inspira Financial Inc
LND.DB	Inspira Financial Inc 4.00 Pct Debs
LNE	Loon Energy Corporation
LOT	Tomagold Corporation
LPC	Lorne Park Capital Partn
LPK	Lupaka Gold Corp
LPS	Legend Power Systems Inc
LRA	Lara Exploration Ltd
LRL	Luxor Industrial Corpora
LRN	Kgic Inc
LSI	Lonestar West Inc.
LTG	Lateral Gold Corp
LTV	Leonovus Inc
LTX	Labrador Technologies In
LVL	Lynden Energy Corp.
LXE	Leucrotta Exploration In
M	Mosaic Capital Corporati
M.PR.A	Mosaic Capital Corp Pref
MAC	Themac Resources Group L
MAD	Miranda Gold Corp.
MAE	Maritime Resources Corp.
MAH	Marksmen Energy Inc.
MAI	Minera Alamos Inc
MAN	Monster Mining Corp
MAP.P	Maple Peak Investments I
MAS	Masuparia Gold Corp.
MAT	Matamec Explorations Inc
MAZ.H	Mazarin Inc.
MBG	Malbex Resources Inc.
MBI	Med Biogene Inc.
MBO	Mobio Technologies Inc
MCA	Milner Consolidated Silv
MCC	Magor Corporation
MCE	Minecorp Energy Ltd
MCG	Mountain China Resorts H
MCI	Minnova Corp
MCK	Manson Creek Resources L
MCM.A	Matachewan Cons Mines
MCP.P	Maestro Capital Corporat
MCR	Macro Enterprises Inc.
MCS	Mcchip Resources Inc
MCU	Mega Copper Ltd.
MCW	Mcw Energy Group Limited
MD	Midland Exploration Inc.
MDL	Medallion Resources Ltd.
MDV	Megastar Development Cor
MDX	Medx Health Corp
MED	Medgold Resources Corp
MEI	Manitok Energy Inc.
MEK	Metals Creek Resources C
MEP	Marsa Energy Inc
MEZ	Mezzotin Minerals Inc.
MFM	Marifil Mines Ltd.
MFS	Medifocus Inc
MFX	Minfocus Exploration Cor
MGG	Minaurum Gold Inc.
MGI	Magnum Goldcorp Inc
MGS	Musgrove Minerals Corp
MGW	Maple Leaf Green World I
MGZ.H	Mangazeya Mining Ltd
MI	Mitchell Resources Ltd
MIA.P	Mira Ix Acquisition Corp
MIN	Excelsior Mining Corp
MIO	Mindoro Resources Ltd
MIR	Medmira Inc
MIT	The Mint Corporation
MIX	Micrex Development Corp
MJN	Pharmacan Capital Corp
MJS	Majestic Gold Corp.
MJX	Majescor Resources Inc.
MKA	Mkango Resources Ltd.
MKN	Makena Resources Inc
MKR	Melkior Resources Inc
MKT	Deepmarkit Corp
MLM	Millstream Mines Ltd.
MLN	Marlin Gold Mining Ltd
MLR	Melior Resources Inc
MLY	American Cumo Mining Cor
MMA	Midnight Sun Mining Corp
MML	Menika Mining Ltd
MMS	Macarthur Minerals Limit
MMV	Mineral Mountain Resourc
MMX	Macmillan Minerals Inc
MMY	Monument Mining Limited
MNH	Mena Hydrocarbons Inc
MNM	Magellan Minerals Ltd.
MNP	Mnp Petroleum Corporatio
MNX	Manitex Capital Inc.
MNY	Montan Mining Corp
MOC	Morumbi Resources Inc
MOE.H	Metropolitan Energy Corp
MOI	Mincom Capital Inc
MOM	Miraculins Inc.
MON	Montero Mining and Explo
MOO	Mooncor Oil and Gas Corp
MOR	Morgan Resources Corp
MOX	Morien Resources Corp
MPH	Medicure Inc
MPL	Maple Leaf Royalties Cor
MPS	Mph Ventures Corp.
MPT	Midpoint Holdings Ltd
MQL	Marquee Energy Ltd
MQR	Monarques Gold Corporati
MQR.WT.A	Monarques Gold Corporati
MRB	Morro Bay Resources Ltd
MRO	Millrock Resources Inc.
MRS	Mission Ready Services I
MRZ	Mirasol Resources Ltd.
MSA	Mesa Exploration Corp
MSD	Moseda Technologies Inc
MSP	Minaean SP Construction
MSR	Minsud Resources Corp.
MT	Mettrum Health Corp
MTB	Mountain Boy Minerals Lt
MTC	Metalcorp Ltd.
MTE	Mitra Energy Inc
MTH	Mammoth Resources Corp
MTM.H	Mitec Technologies Inc
MTO	Metanor Res Inc.
MTS	Metallis Resources Inc
MTU	Manitou Gold Inc
MTX	Metalex Ventures Ltd.
MTZ	Montana Exploration Corp
MU.H	0Nemonster Uranium Corp
MUM	Mustang Minerals Corp.
MUN	Mundoro Capital Inc
MV	Movit Media Corp
MVA.P	Mira Vii Acquisition Cor
MVM	Millenmin Ventures Inc
MVN	Madalena Energy Inc
MVP	Mediavalet Inc
MVW	Mountainview Energy Ltd.
MWI.UN	Maplewood International
MXI	Merrex Gold Inc.
MXM	Maxim Resources Inc.
MXR	Max Resource Corp
MXX	Matrrix Energy Technolog
MYA	Maya Gold & Silver Inc.
MZA.H	Miza Enterprises Inc
MZI	Mezzi Holdings Inc
NAA	Sierra Iron Ore Corp
NAI	Northern Abitibi Mng Cor
NAN	North American Nickel In
NAP	Napier Ventures Inc
NAR	North Arrow Minerals Inc
NBR	Nubian Resources Ltd
NBU	Nebu Resources Inc.
NCA	Newcastle Gold Ltd
NCE	Nesscap Energy Inc
NCI	Ntg Clarity Networks Inc
NCO	Nuvolt Corporation Inc.
NCX	Northisle Copper and Gol
NDR	New Dimension Resources
NED	New Destiny Mining Corp.
NEE	Northern Vertex Mining C
NEL.UN	Nobel Real Estate Invest
NEM	New Era Minerals Inc
NEO.H	Neoteck Solutions Inc
NER	Newmac Resources Inc
NET	Network Exploration Ltd.
NEV	Nevada Sunrise Gold Corp
NFD.A	Northfield Capital Corp.
NFE	Northern Iron Corp
NFK.H	Africa Hydrocarbons Inc
NFR	Northern Freegold Resour
NGC	Northern Graphite Corpor
NGE	Nevada Exploration Inc.
NGH	Nightingale Informatix C
NGM	Northern Gold Mining Inc
NGY.H	Newcastle Energy Corp
NGZ	0Nenrg Metals Inc
NHK	Nighthawk Gold Corp
NIA	Niagara Ventures Corpora
NIC	Pure Nickel Inc
NIK	Nikos Explorations Ltd.
NIM	Nicola Mining Inc
NIO	Niocan Inc
NIP	Nippon Dragon Resources
NIR	Noble Iron Inc
NKW	Naikun Wind Energy Group
NL	Northern Lion Gold Corp
NLL	Nsi Strategic Investment
NM	Northern Empire Resource
NMD	Nomad Ventures Inc
NMG	Noble Metal Group Inc
NMX	Nemaska Lithium Inc
NNA	New Nadina Explorations
NNO	Nano One Materials Corp
NNP	Newnorth Projects Ltd.
NNX	Nickel North Exploration
NOG	Nordic Oil & Gas Ltd.
NOL.H	Knol Resources Corp
NOR	North Group Finance Limi
NOT	Noront Resources Ltd.
NOU	Nouveau Monde Mining Ent
NOX	Niogold Mining Corp.
NPA	Alphinat Inc.
NPD	North American Potash De
NPH	Vanc Pharmaceuticals Inc
NQ	Northquest Ltd.
NQE	Nq Exploration Inc.
NR	Newstrike Resources Ltd.
NRL	Natan Resources Ltd
NRM	Noram Ventures Inc
NRN	Northern Shield Resource
NRT	Big North Graphite Corp
NSC	Northern Sun Mining Corp
NSP	Naturally Splendid Enter
NSX	Nsgold Corporation
NSY	Nsx Silver Inc
NTC	North American Tungsten
NTE	Network Media Group Inc
NTN.H	Newton Energy Corporatio
NTQ	Novateqni Corporation
NTS	Nanotech Security Corp
NTY	92 Resources Corp
NU	Neutrisci International
NUG	Nulegacy Gold Coporation
NUK	North Sea Energy Inc
NVM	Nevada Clean Magnesium I
NVO	Novo Resources Corp
NVT	Nortec Minerals Corp.
NVV	Norvista Capital Corp
NVX	Nv Gold Corporation
NVY	Navy Resources Corp
NW	New World Resources Corp
NWE	New West Energy Services
NWX	Newport Exloration Ltd
NX	Noka Resources Inc
NXE	Nexgen Energy Ltd
NXE.WT	Nexgen Energy Ltd Wts
NXG	Nexgenrx Inc.
NXS	Nexus Gold Corp
NXT	Natcore Technology Inc.
NXX	Nordex Explosives Ltd
NYX	Nyx Gaming Group Limited
NYX.DB	Nyx Gaming Group Ltd 9.0 Pct De
NYX.WT	Nyx Gaming Group Ltd Wts
NZ	New Zealand Energy Corp
NZN	Nevada Zinc Corporation
OA.H	Oramericas Corp
OCN	Oceanus Resources Corp
OCO	Oroco Resource Corp.
ODN	Odin Mining and Explorat
ODS	Odesia Group Inc.
OEC	Oracle Energy Corp
OEE	Astrix Networks Inc
OEG	Onenergy Inc
OGI	Organigram Holdings Inc
OIL	Lgx Oil and Gas Inc
OLA	Orla Mining Ltd
OLV	Olivut Resources Ltd.
OML	Omni-Lite Industries Can
OMM	Omineca Mining and Metal
OMN	Oracle Mining Corp
OMR.H	Ord Mountain Resources C
ON	Oneroof Energy Group Inc
ONE	01 Communique Laboratory
OOI	Oil Optimization Inc
OOO	Otis Gold Corp.
OPA	Opal Energy Corp
OPS	Opsens Inc.
OPW	Opawica Explorations Inc
ORC.B	Orca Exploration Group I
ORG	Orca Gold Inc
ORR	Orofino Minerals Inc
ORS	Orestone Mining Corp
ORX	Orefinders Resources Inc
OSS	Onesoft Solutions Inc
OVT	Oculus Visiontech Inc
OX	Orex Exploration Inc.
OY	Oyster Oil and Gas Ltd
OYL	Cgx Energy Inc
PA	Palamina Corp
PAK	Pacific Coal Resources L
PAN	Pangolin Diamonds Corp
PBM	Pacific Bay Minerals Ltd
PBR	Para Resources Inc
PBS	Pacgen Life Science Corp
PCI	Perlite Canada Inc.
PCO	Phoenix Canada Oil Co.Lt
PCQ	Petrolympic Ltd.
PCR	Pinecrest Resources Ltd
PCS	Platinum Communications
PCV	Pacific Cascade Minerals
PCV.H	Pacific Cascade Minerals Inc
PDA.H	Panda Capital Inc
PDP	Pediapharm Inc
PDQ	Petrodorado Energy Ltd
PE	Pure Energy Minerals Lim
PEA	Petrolia Inc.
PEH	Primeline Energy Holding
PEO	People Corporation
PET	Peat Resources Ltd.
PEX	Pacific Ridge Exploratio
PFC	Petrofrontier Corp.
PFM	Prontoforms Corporation
PFN	Pacific North West Capit
PGC	Plato Gold Corp.
PGE	Group Ten Metals Inc
PGM	Pure Gold Mining Inc
PGO.H	Pacific Geoinfo Corp.
PGV	Prodigy Ventures Inc
PGX	Prosper Gold Corp
PGZ	Pan Global Resources Inc
PHC.H	Phoenix Metals Corporati
PHI	Philippine Metals Inc
PHL.H	Planet Health Corp
PHM	Patient Home Monitoring
PHM.DB	Patient Home Monitoring
PHO	Photon Control Inc.
PIT.H	Pitchblack Resources Ltd
PJT	Partner Jet Corp.
PJX	Pjx Resources Inc
PKC.H	Pacific Link Mining Corp
PKL	PC Gold Inc
PKT	Parkit Enterprise Inc
PLA	Plata Latina Minerals Co
PLC	Park Lawn Corporation
PLP.H	Plicit Capital Corp
PLR	Plate Resources Inc
PLU	Plateau Uranium Inc
PLY	Playfair Mining Ltd
PM	Prism Medical Ltd.
PMA	Petromaroc Corporation P
PMD	Prima Diamond Corp
PMI	Petromanas Energy Inc.
PML	Panoro Minerals Ltd
PMO.H	Prime City One Capital C
PMR	Prime Meridian Resources
PMX	Proam Exploration Corpor
PNE	Pine Cliff Energy Ltd.
PNE.R	Pine Cliff Energy Ltd Sub Receipts
PNG	Kraken Sonar Inc
PNN	Pennine Petroleum Corpor
PNR.H	Prince Resource Corp
POC	Pacific Iron Ore Corpora
POE	Pan Orient Energy Corp.
POP	Petro One Energy Corp
POR	Portofino Resources Inc
PPA	Panorama Petroleum Inc
PPC	Patriot Petroleum Corp.
PPE	Pacific Paradym Energy I
PPK	Prospect Park Capital Co
PPP	Parlane Resource Corp
PPV.H	P and P Ventures Inc
PPX	Peruvian Precious Metals
PPZ.H	Pacific Topaz Resources
PRB	Probe Metals Inc
PRD	Prd Energy Inc
PRG	Precipitate Gold Corp
PRH	Pearl River Holdings Ltd
PRJ	Petro Rio Sa
PRN	Profound Medical Corp
PRO	Pershimco Resources Inc.
PRS.H	Prism Res Inc.
PRV.UN	Pro Real Estate Investme
PRV.WT	Pro Real Estate Investme
PSH	Petroshale Inc
PSL	Prospero Silver Corp.
PSP	Pacific Safety Products
PST	Pistol Bay Mining Inc
PTA	Petroamerica Oil Corp.
PTC	Petrox Resources Corp
PTE	Pioneering Technology Co
PTF	Pender Growth Fund Vcc I
PTG	Pivot Technology Solutio
PTK	Poet Technologies Inc
PTP	Petrichor Energy Inc
PTR	Petromin Resources Ltd.
PTU	Purepoint Uranium Group
PTX	Platinex Inc.
PUC	Pancontinental Uranium C
PUM	Puma Exploration Inc
PVF	Partners Value Fund Inc
PX	Pelangio Exploration Inc
PXA	Phoenix Gold Resources C
PXI	Planet Mining Exploratio
PYD	Poydras Gaming Finance C
PYD.DB.U	Poydras Gaming Finance 1
PYR	Pyrogenesis Canada Inc
PYT	Pyng Medical Corp.
Q.A	Questfire Energy Corp Cl
Q.B	Questfire Energy Corp Cl
QF	0Nequickflow Health Inc
QGR	Q Gold Resources Ltd
QHR	Qhr Corporation
QI	Q Investments Ltd.
QIC	Quantum International In
QIS	Quorum Information Techn
QIT	Quinto Real Capital Corp
QMX	Qmx Gold Corporation
QPT	Quest Pharmatech Inc.
QQ	Quizam Media Corporation
QST	Questor Technology Inc.
QTA	Quaterra Resources Inc.
QXP	Quattro Exploration and
QZM	Quartz Mountain Resource
RAB	Rambler Metals and Minin
RAK	Rackla Metals Inc
RAU.H	Regency Gold Corp.
RB	Russell Breweries Inc.
RBE	Rockbridge Resources Inc
RBX	Robex Resources Inc
RCK	Rock Tech Lithium Inc
RCT	Rochester Resources Ltd.
RCU	Rockcliff Copper Corporation
RD	Red Eagle Mining Corp
RDS	Radisson Mining Resource
RDU	Radius Gold Inc.
REC	Reliant Gold Corp
REG	Regulus Resources Inc
REK	Reko International Group
REL	Roughrider Exploration L
REN	Renaissance Gold Inc
REO	Reservoir Capital Corp.
RER	Remo Resources Inc
REX	Orex Minerals Inc
REZ	Redzone Resources Ltd
RFC	Rifco Inc.
RG	Romios Gold Resources In
RGC	Redstar Gold Corp.
RGD	Reunion Gold Corporation
RGI	Reco International Group Inc.
RGM	Remington Resources Inc.
RGZ	Randsburg International
RHA	Annidis Corporation
RHC	Rockefeller Hughes Corpo
RHR	Redhill Resources Corp
RI	Reliance Resources Limit
RIN	Resinco Capital Partners
RIR	Rainmaker Resources Ltd
RJ	Rojo Resources Ltd
RJX.A	Rjk Explorations Ltd. C
RK	Rockhaven Resources Ltd.
RKR	Rokmaster Resources Corp
RL	Rockland Minerals Corp
RM	Rodinia Lithium Inc.
RMC	Reservoir Minerals Inc
RMD	Richmond Minerals Inc.
RMK	Red Moon Potash Inc
RML	Rusoro Mining Ltd
RMN	Red Tiger Mining Inc
RMO	Rainy Mountain Royalty C
RMR	Rome Resources Ltd.
RMT	Raimount Energy Inc
ROB	Red Hut Metals Inc
ROC	Red Oak Mining Corp
ROE	Renaissance Oil Corp
ROE.WT	Renaissance Oil Corp Wts
ROG	Roxgold Inc.
ROI	Route1 Inc.
ROL.P	Roll Up Capital Corp
ROS.H	Roscan Minerals Corporat
ROX	Canstar Resources Inc.
RP	Replicel Life Sciences I
RPC	Raise Production Inc
RPM	Rye Patch Gold Corp
RPP	Regent Pacific Propertie
RPR	Rapier Gold Inc
RPT	Arpetrol Ltd
RPX	Red Pine Exploration Inc
RQM.H	Redquest Capital Corp
RRC	Rockridge Capital Corp.
RRE	Reg Technologies Inc
RRI	Riverside Resources Inc.
RRK	Red Rock Energy Inc.
RRL	Relentless Resources Ltd
RRR.UN	R and R Real Estate Inve
RRS	Rogue Resources Inc
RSL	Royal Sapphire Corp
RST	Rosita Mining Corporatio
RSV	Resolve Ventures Inc.
RSY	Rsi International System
RTH	Rathdowney Resources Ltd
RTI	Radient Technologies Inc
RTM	Rt Minerals Corp
RUF.DB.U	Pure Multi Family REIT L
RUF.U	Pure Multi Family REIT L
RUF.UN	Pure Multi Family REIT L
RUG	Rugby Mining Limited
RUM	Rocky Mountain Liquor In
RUM.DB	Rocky Mountain Liquor In
RUN	Running Fox Resource Cor
RUP	Rupert Resources Ltd.
RVA	Reva Resources Corp.
RVL	Revelo Resources Corp
RVV	Revive Therapeutics Ltd
RW	Renoworks Software Inc.
RX	Biosyent Inc.
RYO	Rio Silver Inc
RYP.H	Ripper Oil and Gas Inc
RYR	Royal Road Minerals Limi
RYU	Ryu Apparel Inc
RZ	Revolver Resources Inc
RZZ	Abitibi Royalties Inc
SA	Southern Arc Minerals In
SAB.H	Saber Capital Corp
SAE	Sable Resources Ltd
SAH	Sahara Energy Ltd
SAI	Sunshine Agri Tech Inc.
SAO	San Angelo Oil Limited
SAT	Asian Television Network
SAY.H	Sparta Capital Ltd
SBG.H	Spirit Bear Capital Corp
SBL.H	Santa Barbara Resources
SBM	Sirona Biochem Corp.
SBW	Strongbow Exploration In
SBX	Sea Breeze Power Corp
SC.H	Serrano Resources Ltd
SCA	Savary Gold Corp
SCD	Samoth Oilfield Inc.
SCG	Selectcore Ltd.
SCR	Thescore Inc
SCR.WT	Thescore Inc Wts
SCZ	Santacruz Silver Mining
SDC	Solidusgold Inc
SDE	Standard Exploration Ltd
SDS	Seair Inc.
SDX	Sea Dragon Energy Inc.
SDZ	Security Devices Interna
SE	Stonehaven Exploraton Lt
SEB	Smart Employee Benefits
SEI	Sintana Energy Inc
SEK	Secova Metals Corp.
SEW	Seaway Energy Services I
SFD	Nxt Energy Solutions Inc
SFM	Santa Fe Metals Corporat
SFT	Softrock Minerals Ltd.
SFX	Sphinx Resources Ltd
SG	Sg Spirit Gold Inc
SGA	Samco Gold Limited
SGB	Solegear Bioplastic Tech
SGC	Sunridge Gold Corp
SGC.WT	Sunridge Gold Corp Wts
SGE	Strategem Capital Corp
SGG	Snipgold Corp
SGH	Standard Graphite Corpor
SGM	Sutter Gold Mining Inc.
SGN	Scorpio Gold Corporation
SGU	Signature Resources Ltd
SGW	Shoal Games Ltd
SGX	Sage Gold Inc.
SGZ	Sego Resources Inc.
SHI	Sunrise Resources Ltd
SHJ	Shoshoni Gold Ltd
SHL	Spruce Ridge Resources L
SI	Stratton Resources Inc
SIC	Sokoman Iron Corp
SIE	Sienna Resources Inc
SIL	Silvercrest Metals Inc
SIM	Siyata Mobile Inc.
SIO	Sensio Technologies Inc.
SIP	Sniper Resources Ltd.
SIR	Serengeti Resources Inc.
SJL	Saint Jean Carbon Inc
SJR.A	Shaw Communications Inc.
SKE	Skeena Resources Limited
SKK	Strikewell Energy Corp.
SKP	Strikepoint Gold Inc.
SKX	Striker Exploration Corp
SLC	Slyce Inc
SLG	Sterling Resources Ltd
SLK	Silk Road Energy Inc
SLM	Slater Mining Corporatio
SMB	Simba Energy Inc.
SMD	Strategic Metals Ltd
SME	Sama Resources Inc Resso
SMI	Saturn Minerals Inc.
SMM	Silver Mountain Mines In
SMN	San Marco Resources Inc.
SMO	Sonoro Metals Corp
SMP	Strata Minerals Inc
SMQ.H	Santa Maria Petroleum In
SMS	Sustainco Inc
SMY	Search Minerals Inc.
SN	Sennen Potash Corporatio
SNA	Star Navigation Systems
SNF	Sunora Foods Inc
SNG	Silver Range Resources L
SNI.PR.A	Sonor Investments Limited
SNM	Shamaran Petroleum Corp.
SNR	Senator Minerals Inc.
SNS	Select Sands Corp
SNV	Sonoro Energy Ltd
SOC	Sonora Gold & Silver Cor
SOF	International Softrock O
SOG	Strategic Oil and Gas Lt
SOI	Sirios Resources Inc.
SOJ	Sojourn Ventures Inc
SOP	Source Exploration Corp.
SOR	Sora Capital Corp
SPA	Spanish Mountain Gold Lt
SPC	Superior Copper Corp
SPD	Silver Predator Corp
SPF	Silver Pursuit Resources
SPI	Canadian Spirit Resource
SPK	Sunset Pacific Petroleum
SPN	Snipp Interactive Inc
SPP	Spot Coffee Canada Ltd.
SPS.A	Sportscene Group Inc.
SPT	Stockport Exploration Inc
SPX	Stellar Africagold Inc
SQD	Sqi Diagnostics Inc.
SQG	Spackman Equities Group
SRA	Stria Lithium Inc
SRC	Stakeholder Gold Corp
SRE	Saville Resources Inc.
SRI	Sparton Resources Inc
SRJ	Spearmint Resources Inc
SRK	Strike Diamond Corp
SRL	Salazar Resources Limite
SRO	Section Rouge Media Inc.
SRX	Storm Resources Ltd
SS	Summus Solutions Nv
SSA	Spectra Inc
SSC	Smartcool Systems Inc.
SSE	Silver Spruce Resources
SSG	Sigma Industries Inc
SSI	Southern Sun Minerals In
SSN	Stetson Oil
SSP	Sandspring Resources Ltd
SSR.H	Silver Shield Resources
SSV	Southern Silver Explorat
STA	Sanatana Resources Inc
STC	Sangoma Technologies Cor
STE	Starr Peak Exploration Ltd
STH	Stelmine Canada Ltd.
STI	Strategic Resources Inc
STR.H	Santa Rosa Resources Cor
STS.H	Stem 7 Capital Inc
STT	Stt Enviro Corp
SUD.A	Starlight US Multi Famil
SUF.A	Starlight US Multi Famil
SUF.U	Starlight US Multi Famil
SUG	Suparna Gold Corp
SUI.H	Superior Mining Internat
SUL	Sultan Minerals Inc.
SUP	Northern Superior Resour
SUS.A	Starlight US Multi Famil
SV	Simavita Limited
SVA	Sernova Corp.
SVG	Silver Grail Resources L
SVI	Storagevault Canada Inc.
SVP.H	Sceptre Ventures Inc
SVS	Solarvest Bioenergy Inc
SVT	Savant Explorations Ltd.
SWA	Sarama Resources Ltd
SWR.H	Swift Resources Inc
SXE	Strata X Energy Ltd
SXL	Slam Exploration Inc
SXR	SGX Resources Inc
SY	Symbility Solutions Inc
SYD	Synodon Inc.
SYH	Skyharbour Resources Ltd
SYI	Silvermet Inc.
SYL	Symax Lift Holding Co. L
SYN	Syncordia Tech and Healt
SYR.H	Sky Ridge Resources Ltd
SYS	Sona Resources Corp
SYZ	Sylogist Ltd
SZM	Scozinc Mining Ltd
TAC	Tasca Resources Ltd
TAE	Transamerican Energy Inc
TAJ	Tajiri Resources Corp
TAN	Tanager Energy Inc
TAR	Astar Minerals Ltd
TAU	Tintina Resources Inc.
TAW	Tawsho Mining Inc.
TBO	Turbo Capital Inc
TBR	Timberline Resources Cor
TCA	Timia Capital Corp
TCX	Thermoceramix Corporatio
TDR.H	Tudor Corporation Ltd
TE	Trinity Valley Energy Co
TEA	Tearlach Resources Limit
TEM	Tembo Gold Corp
TEN	Terraco Gold Corp.
TEP.DB	Transeastern Power Trust
TEP.UN	Transeastern Power Trust
TES	Tesoro Minerals Corp
TGC	Terra Nova Energy Ltd
TGI.H	True Grit Resources Ltd
TGK	Trio Gold Corp
TGM	True Gold Mining Inc
TGR	Tiger International Reso
TGV	Tango Mining Limited
TGX	True North GEMS Inc.
THH	Theia Resources Ltd.
THR	Thundermin Resources Inc
THX	Thor Explorations Ltd.
TIC	Titanium Corporation Inc
TII	Terra Firma Capital Corp
TIL	Till Capital Ltd
TIN	Eurotin Inc
TIP.H	Tyner Resources Ltd
TIR	Tiller Resources Ltd
TJ	Tad Mineral Exploration
TK	Tinka Resources Ltd
TKK	Takara Resources Inc.
TKU	Tarku Resources Ltd
TLA	Titan Logix Corp
TLK	Frankly Inc
TLT	Theralase Technologies I
TMG	Thermal Energy Internati
TMV	3Mv Energy Corp
TNA	Evergreen Gaming Corpora
TNC	Tio Networks Corp.
TNG	Transgaming Inc.
TNO.H	Terreno Resources Corp
TNR	Tnr Gold Corp
TOE	Tri Origin Exploration L
TOM	Tolima Gold Inc
TON	Standard Tolling Corp
TOO	Toro Oil and Gas Ltd
TPC	Tenth Avenue Petroleum C
TPN	Taipan Resources Inc.
TQY.H	Tanqueray Exploration Lt
TRA	Teras Resources Inc
TRB	Tribute Resources Inc
TRG.H	Trigen Resources Inc
TRM	Trueclaim Exploration In
TRO	Taranis Resources Inc.
TRS	Tres-Or Resources Ltd.
TRU	Trius Investments Inc.
TRX	Tribute Pharmaceuticals
TSD	Tsodilo Resources Ltd
TSG	Tristar Gold Inc.
TSM	Tasman Metals Ltd.
TSN	Telson Resources Inc
TSP	Titan Star Properties In
TSP.DB	Titanstar Properties Inc
TSR.H	Top Strike Resources Cor
TTD	Tinkerine Studios Ltd
TTM	3Tl Technologies Corp
TTR	Titanium Transportation
TTZ	Total Telcom Inc.
TUF	Honey Badger Exploration
TUO	Teuton Resources Corp
TUS	Tuscany Energy Ltd
TVL	Traverse Energy Ltd.
TWM	Tidewater Midstream and
TWR	Tower Resources Ltd
TXR	Terrax Minerals Inc.
TXX	Tirex Resources Ltd.
TYE	Troymet Exploration Corp
TYP	Typhoon Exploration Inc.
TZM	Tanzania Minerals Corp
TZR	Terrace Energy Corp
UBN	Urban Communications Inc
UBR	Uragold Bay Resources In
UBS.H	Unique Broadband Systems
UCU	Ucore Rare Metals Inc
UFC	Urbanfund Corp.
UG	Uge International Ltd
UGD	Unigold Inc.
UI	Urbanimmersive Technolog
ULI	Ultra Lithium Inc.
UMF.A	Starlight US Multi Famil
UMF.U	Starlight US Multi Famil
UNI	Unisync Corp Class B
UNO	Northern Uranium Corp
URA	Anglo Canadian Mining Co
URC	Uracan Resources Ltd.
USO	US Oil Sands Inc
USR	Uranium Standard Resourc
USS	Uniserve Communications
UTY	Unity Energy Corp
UVN	Uravan Minerals Inc.
VAL	Valgold Resources Ltd
VAN	Vangold Resources Ltd
VAX	Vantex Resources Ltd.
VBI.H	Vivione Biosciences Inc
VCI	Vitreous Glass Inc.
VCV.H	Vatic Ventures Corp
VDO	Nevado Resources Corpora
VDR	Vendome Resources Corp.
VEL	Vanoil Energy Ltd.
VFI.H	Verdant Financial Partne
VGD	Visible Gold Mines Inc.
VGL	Vigil Health Solutions I
VGN	Greencastle Res Ltd.
VGO	Vogogo Inc
VHO	Virginia Hills Oil Corp
VID	Vidwrx
VIE.P	Vier Capital Corp
VIO	Societe D Exploration Mi
VIS	Visionstate Corp
VIT	Victoria Gold Corp.
VIV	Avivagen Inc
VLA	Vela Minerals Ltd
VLV	Venerable Ventures Ltd.
VML	Viscount Mining Corp
VMS	Vms Ventures Inc.
VMY.H	Voice Mobility Internati
VOL	Volcanic Metals Corp
VPI	Vitality Products Inc.
VPO.H	Valparaiso Energy Inc.
VPT	Ventripoint Diagnostics
VPY	Versapay Corporation
VQA	Valterra Resource Corp
VQS	Viq Solutions Inc.
VR	Victory Resources Corpor
VRB	Vanadiumcorp Resource In
VRD	Viridis Energy Inc.
VRS	Verisante Technology Inc
VRY	Petro Victory Energy Cor
VSR	Vanstar Mining Resources
VTI	Valdor Technology Intern
VTT	Vendetta Mining Corp
VUI	Virginia Energy Resource
VUL	Vulcan Minerals Inc
VV	Versatile Systems Inc.
VVA	Avagenesis Corp
VVC	Vvc Exploration Corp.
VVN	Victory Ventures Inc
VZZ	Uranium Valley Mines Ltd
WAF	West African Resources L
WAF.WT	West African Resources L
WAI	Wai Capital Investments
WAR	War Eagle Mining Company
WAS.H	Watusi Capital Corp
WAV	Pepcap Resources Inc
WBE	Westbond Enterprises Cor
WCB	Wcb Resources Ltd
WCC	Consolidated Woodjam Cop
WCE	Wescan Energy Corp
WCX	Williams Creek Gold Limi
WEB	Westbridge Energy Corpor
WED	The Westaim Corporation
WEE	Wavefront Technology Sol
WEL	Wildcat Exploration Ltd.
WFG	Waterfront Capital Corpo
WGF	Wescan Goldfields Inc
WGX.H	Whistler Gold Exploratio
WHM	White Metal Resources Co
WHN	Westhaven Ventures Inc
WHY	West High Yield Resource
WIL	Wilton Resources Inc
WKG	Westkam Gold Corp
WKM	West Kirkland Mining Inc
WKM.WT	West Kirkland Mining Inc
WLF	Wolfden Resources Corpor
WLV	Wolverine Minerals Corp.
WMK.H	Whitemud Resources Inc
WML	Wealth Minerals Ltd.
WMM	West Melville Metals Inc
WMR	Westminster Resources Lt
WMT	West Mountain Environmen
WP	Western Pacific Trust Co
WPQ	Wpc Resources Inc
WPR	White Pine Resources Inc
WR	Worldwide Resources Corp
WRI	Waseco Resources Inc.
WRP	Western Pacific Resource
WRR	Walker River Resources C
WRY	Western Troy Cap Res Inc
WSE	Wellstar Energy Corp
WST	Westridge Resources Inc
WT.H	Wangton Capital Corp
WTR	Westcore Energy Ltd.
WZR	Westernzagros Resources
XAG	Xtierra Inc.
XAU	Bitgold Inc
XBC	Xebec Adsorption Inc
XCX	Chinook Tyee Industry Li
XI	Exclamation Investments
XIA	Xiana Mining Inc
XIM	Ximen Mining Corp
XL	Xxl Energy Corp.
XME	Xmet Inc
XND	Xander Resources Inc
XOP	Canadian Overseas Petrol
XTM	Transition Metals Corp
XTT	X Terra Resources Inc
XX	Avante Logixx Inc
XYL	Xylitol Canada Inc.
YAK	Mongolia Growth Group Lt
YFI	Edgewater Wireless Syste
YO	Yoho Resources Inc
YOO	Yangaroo Inc
YTY	Wi2Wi Corporation
ZAD	Zadar Ventures Ltd
ZAO	Zaio Corporation
ZC	Zimtu Capital Corp.
ZCC	Zena Mining Corp.
ZEE	Zenith Energy Ltd
ZEN	Zenyatta Ventures Ltd.
ZFR	Zephyr Minerals Ltd
ZIM	Zinco Mining Corporation
ZKL	China Keli Electric Co Ltd
ZMD	Zoommed Inc.
ZMS	Zecotek Photonics Inc.
ZNC.H	Zincore Metals Inc
ZON	Zonte Metals Inc
ZUM	Zoomermedia Limited
